{
  "tileSize": 5,
  "palette": {
    "1": { "color": "#e67e22", "collides": true },
    "2": { "color": "#d35400", "collides": true },
    "3": { "color": "#9b59b6", "collides": true },
    "4": { "color": "#8e44ad" }
  },
  "layers": [{
    "tiles": [[1,1,1,1,1,1,1,1,1,1,0,0,0,1,1,1,1],
              [1,0,0,0,0,1,0,0,0,1,0,0,0,2,0,0,3],
              [1,0,0,0,0,0,0,0,0,1,1,1,1,1,0,2,2],
              [1,0,0,0,0,0,0,0,0,0,0,0,0,0,0,0,3],
              [1,0,0,0,0,0,0,0,0,1,1,1,1,1,1,2,2],
              [1,0,0,0,0,1,0,0,0,1,0,0,0,0,0,0,0],
              [1,1,1,1,1,1,1,1,1,1,0,0,0,0,0,0,0]]
  }]
}
